"filename", "language", "C++", "Markdown", "C", "comment", "blank", "total"
"d:\VSCodeCppProject\CProject\ASCIIone\ASCIIone.c", "C", 0, 0, 13, 0, 1, 14
"d:\VSCodeCppProject\CProject\Arithmetic\arithmetic.c", "C", 0, 0, 23, 0, 2, 25
"d:\VSCodeCppProject\CProject\AverageCount\AverageCount.c", "C", 0, 0, 23, 0, 1, 24
"d:\VSCodeCppProject\CProject\CalThreefun\CalThreefun.c", "C", 0, 0, 22, 0, 2, 24
"d:\VSCodeCppProject\CProject\Cowcount\Cowcount.c", "C", 0, 0, 24, 0, 5, 29
"d:\VSCodeCppProject\CProject\Daffodil\Daffodilone.c", "C", 0, 0, 31, 0, 2, 33
"d:\VSCodeCppProject\CProject\Sort_three\Sort_three.c", "C", 0, 0, 37, 0, 2, 39
"d:\VSCodeCppProject\CProject\SumFactorial\SumFactorial.c", "C", 0, 0, 29, 0, 3, 32
"d:\VSCodeCppProject\CProject\TemperatureConversion\TemperatureConversion.c", "C", 0, 0, 7, 0, 1, 8
"d:\VSCodeCppProject\CProject\maxThreeNumber\maxThreeNumber.c", "C", 0, 0, 15, 1, 2, 18
"d:\VSCodeCppProject\CProject\maxTwoNumber\maxTwoNumber.c", "C", 0, 0, 15, 0, 2, 17
"d:\VSCodeCppProject\CProject\reverseMore\reverseMore.c", "C", 0, 0, 31, 0, 2, 33
"d:\VSCodeCppProject\CppProject\Project10\ten.cpp", "C++", 65, 0, 0, 2, 12, 79
"d:\VSCodeCppProject\CppProject\Project11\eleven.cpp", "C++", 69, 0, 0, 3, 9, 81
"d:\VSCodeCppProject\CppProject\Project12\twelve.cpp", "C++", 34, 0, 0, 2, 8, 44
"d:\VSCodeCppProject\CppProject\Project13\thirteen.cpp", "C++", 52, 0, 0, 5, 5, 62
"d:\VSCodeCppProject\CppProject\Project14\fourteen.cpp", "C++", 46, 0, 0, 3, 8, 57
"d:\VSCodeCppProject\CppProject\Project15\fifteen.cpp", "C++", 79, 0, 0, 3, 11, 93
"d:\VSCodeCppProject\CppProject\Project16\sixteen.cpp", "C++", 25, 0, 0, 4, 4, 33
"d:\VSCodeCppProject\CppProject\Project17\seventeen.cpp", "C++", 107, 0, 0, 2, 22, 131
"d:\VSCodeCppProject\CppProject\Project18\eighteen.cpp", "C++", 37, 0, 0, 2, 7, 46
"d:\VSCodeCppProject\CppProject\Project19\nineteen.cpp", "C++", 85, 0, 0, 11, 1, 97
"d:\VSCodeCppProject\CppProject\Project1\one.cpp", "C++", 34, 0, 0, 0, 6, 40
"d:\VSCodeCppProject\CppProject\Project20\twenty.cpp", "C++", 54, 0, 0, 3, 10, 67
"d:\VSCodeCppProject\CppProject\Project21\twentyone.cpp", "C++", 78, 0, 0, 3, 13, 94
"d:\VSCodeCppProject\CppProject\Project22\twentytwo.cpp", "C++", 68, 0, 0, 4, 12, 84
"d:\VSCodeCppProject\CppProject\Project2\two.cpp", "C++", 42, 0, 0, 0, 10, 52
"d:\VSCodeCppProject\CppProject\Project3\three.cpp", "C++", 33, 0, 0, 2, 6, 41
"d:\VSCodeCppProject\CppProject\Project4\four.cpp", "C++", 58, 0, 0, 2, 11, 71
"d:\VSCodeCppProject\CppProject\Project5\five.cpp", "C++", 22, 0, 0, 0, 5, 27
"d:\VSCodeCppProject\CppProject\Project6\six.cpp", "C++", 47, 0, 0, 9, 7, 63
"d:\VSCodeCppProject\CppProject\Project7\seven.cpp", "C++", 17, 0, 0, 1, 1, 19
"d:\VSCodeCppProject\CppProject\Project8\eight.cpp", "C++", 54, 0, 0, 3, 8, 65
"d:\VSCodeCppProject\CppProject\Project9\nine.cpp", "C++", 18, 0, 0, 0, 1, 19
"d:\VSCodeCppProject\LeetCodeProject\Sum_Of_Two_Numbers\Sum_of_two_numbers.cpp", "C++", 38, 0, 0, 0, 2, 40
"d:\VSCodeCppProject\LeetCodeProject\isPalindrome\isPalindrome.cpp", "C++", 48, 0, 0, 0, 4, 52
"d:\VSCodeCppProject\LeetCodeProject\isPalindrome\officialisPalindrome.cpp", "C++", 32, 0, 0, 10, 4, 46
"d:\VSCodeCppProject\LeetCodeProject\reverseInt\REDEME.md", "Markdown", 0, 48, 0, 0, 26, 74
"d:\VSCodeCppProject\LeetCodeProject\reverseInt\reverseInt.cpp", "C++", 29, 0, 0, 0, 4, 33
"d:\VSCodeCppProject\README.md", "Markdown", 0, 153, 0, 0, 3, 156
"d:\VSCodeCppProject\helloworld.cpp", "C++", 24, 0, 0, 0, 3, 27
"Total", "-", 1295, 201, 270, 75, 248, 2089