"filename", "language", "Markdown", "C++", "comment", "blank", "total"
"d:\VSCodeCppProject\LeetCodeProject\Sum_Of_Two_Numbers\Sum_of_two_numbers.cpp", "C++", 0, 38, 0, 2, 40
"d:\VSCodeCppProject\LeetCodeProject\isPalindrome\isPalindrome.cpp", "C++", 0, 48, 0, 4, 52
"d:\VSCodeCppProject\LeetCodeProject\isPalindrome\officialisPalindrome.cpp", "C++", 0, 32, 10, 4, 46
"d:\VSCodeCppProject\LeetCodeProject\reverseInt\REDEME.md", "Markdown", 48, 0, 0, 26, 74
"d:\VSCodeCppProject\LeetCodeProject\reverseInt\reverseInt.cpp", "C++", 0, 29, 0, 4, 33
"d:\VSCodeCppProject\Project10\ten.cpp", "C++", 0, 65, 2, 12, 79
"d:\VSCodeCppProject\Project11\eleven.cpp", "C++", 0, 69, 3, 9, 81
"d:\VSCodeCppProject\Project12\twelve.cpp", "C++", 0, 34, 2, 8, 44
"d:\VSCodeCppProject\Project13\thirteen.cpp", "C++", 0, 52, 5, 5, 62
"d:\VSCodeCppProject\Project14\fourteen.cpp", "C++", 0, 46, 3, 8, 57
"d:\VSCodeCppProject\Project15\fifteen.cpp", "C++", 0, 79, 3, 11, 93
"d:\VSCodeCppProject\Project16\sixteen.cpp", "C++", 0, 25, 4, 4, 33
"d:\VSCodeCppProject\Project17\seventeen.cpp", "C++", 0, 107, 2, 22, 131
"d:\VSCodeCppProject\Project18\eighteen.cpp", "C++", 0, 37, 2, 7, 46
"d:\VSCodeCppProject\Project19\nineteen.cpp", "C++", 0, 85, 11, 1, 97
"d:\VSCodeCppProject\Project1\one.cpp", "C++", 0, 34, 0, 6, 40
"d:\VSCodeCppProject\Project20\twenty.cpp", "C++", 0, 54, 3, 10, 67
"d:\VSCodeCppProject\Project21\twentyone.cpp", "C++", 0, 78, 3, 13, 94
"d:\VSCodeCppProject\Project22\twentytwo.cpp", "C++", 0, 68, 4, 12, 84
"d:\VSCodeCppProject\Project2\two.cpp", "C++", 0, 42, 0, 10, 52
"d:\VSCodeCppProject\Project3\three.cpp", "C++", 0, 33, 2, 6, 41
"d:\VSCodeCppProject\Project4\four.cpp", "C++", 0, 58, 2, 11, 71
"d:\VSCodeCppProject\Project5\five.cpp", "C++", 0, 22, 0, 5, 27
"d:\VSCodeCppProject\Project6\six.cpp", "C++", 0, 47, 9, 7, 63
"d:\VSCodeCppProject\Project7\seven.cpp", "C++", 0, 17, 1, 1, 19
"d:\VSCodeCppProject\Project8\eight.cpp", "C++", 0, 54, 3, 8, 65
"d:\VSCodeCppProject\Project9\nine.cpp", "C++", 0, 18, 0, 1, 19
"d:\VSCodeCppProject\README.md", "Markdown", 116, 0, 0, 2, 118
"d:\VSCodeCppProject\helloworld.cpp", "C++", 0, 24, 0, 3, 27
"Total", "-", 164, 1295, 74, 222, 1755